C 40, 40, 40

NO ./textures/dd1.png
SO ./textures/dd4.png
WE ./textures/dd2.png

F 60, 60, 60


EA ./textures/dd3.png

D ./textures/ddoor.png
M ./textures/ddoorw.png
B ./textures/enemy.png
WAP ./textures/transformed.png

        1111111111111111111111111
        1000000000110000000000001
        1011000000100000000000001
        10010B000030000000B000001
111111111011000000100000000000001
100000000011000001110000112111111
11110111111111011100000010001
11110111111111011101010010N01
11000000110101011100000010001
10000000000000000000000000001
10000000000000001101010010001
1100000111010101111101111000111
11110111 1110101 101111010001
11111111 1111111 111111111111
