C    151, 139, 74

NO ./textures/backroomd.png
SO ./textures/backroomd1.png
WE ./textures/backroom.png


F 161, 147, 59
EA ./textures/backroom1.png

D ./textures/door1.png
M ./textures/doorw.png
B ./textures/zombie.png
WAP ./textures/HUD.png

        1111111111111111111111111
        1000000000110000000000001
        1011000000100000000000001
        100100000030000000B000001
111111111011000000100000000000001
100000000011000001110000112111111
11110111111111011100000010001
11110111111111011101010010001
11000000110101011100000010001
10000000000000000000000000N01
10000000000000001101010010001
1100000111010101111101111000111
11110111 1110101 101111010001
11111111 1111111 111111111111
