C    222 ,    30 ,     0 
NO ./textures/N.png
SO ./textures/S.png
WE ./textures/W.png


F 220,100,   0
EA ./textures/E.png

D ./textures/door.png
M ./textures/doorw.png
B ./textures/enemy.png

        1111111111111111111111111
        1000000000110000000000001
        1011000000000000000000001
        1001000000300000000000001
111111111011000000000000000000001
100000000011000001110000102011111
11110111111111011100000010001
11110111111111011101010010N01
11000000110101011100000010001
10000000000000000000000000001
10000000000000001101010010B01
1100000111010101111101111000111
11110111 1110101 101111010001
11111111 1111111 111111111111
